dX0000X00X0X000/n
0X0XX0X00X000X0/n
000X00X0000XX0X/n
0XXX0XX00X00X00/n
00XR000000X000X/n
0X0XXXX00XXXXXX/n
0X0X00000X00000/n
0X00X000000X000/n
0XX0X0000X000X0/n
0XX0X0X00X0X0X0/n
0X00XX0X0X00X00/n
0X0X000X0XXX0X0/n
000X0X00XX00000/n
0X0X00X00XXXXXX/n
0X000XXX000000f/n