DX0000X00X0X000
0X0XX0X00X000X0
000X00X0000XX0X
0XXX0XX00X00X00
00XR000000X000X
0X0XXXX00XXXXXX
0X0X00000X00000
0X00X000000X000
0XX0X0000X000X0
0XX0X0X00X0X0X0
0X00XX0X0X00X00
0X0X000X0XXX0X0
000X0X00XX00000
0X0X00X00XXXXXX
0X000XXX000000F